NO textures/wall_1.xpm
SO textures/wall_2.xpm
WE textures/wall_3.xpm
EA textures/wall_4.xpm
F 100,100,100
C 200,200,200

1111111111111
1000000000001
1011101110001
1000100010001
1011101110001
1000000000N01
1011101110001
1000100010001
1011101110001
1000000000001
1111111111111
